0,0,0,0,0,0,0,0,0,0,0,0,0,0,0
0,0,0,0,0,0,0,0,0,0,0,0,0,0,0
0,0,0,0,0,0,0,0,0,0,0,0,0,0,0
38,38,38,38,38,38,38,38,38,38,38,38,38,38,38
0,0,0,0,0,0,0,30,0,0,0,0,0,0,0
0,0,0,0,0,0,0,30,0,0,0,0,0,0,0
0,0,0,0,0,0,0,30,0,0,0,0,0,0,0
38,38,38,38,38,38,38,38,38,38,38,38,38,38,38
0,0,0,0,0,0,0,0,0,0,0,0,0,0,0
0,0,0,0,0,0,0,0,0,0,0,0,0,0,0
0,0,0,0,0,0,0,0,0,0,0,0,0,0,0
30,30,30,38,38,38,38,38,38,38,38,38,30,30,30
0,0,0,0,0,0,0,0,0,0,0,0,0,0,0
0,0,0,0,0,0,0,0,0,0,0,0,0,0,0
0,0,0,0,0,0,0,0,0,0,0,0,0,0,0
38,38,38,38,38,38,38,38,38,38,38,38,38,38,38